0,0,0,0,0,0,0,0,0,0,0,0,0,0,0,7,7,7,7,7
0,0,0,0,0,0,0,0,0,0,7,7,7,7,7,0,0,0,0,4
0,0,0,0,0,7,7,7,7,7,0,0,0,0,0,0,0,0,0,0
0,7,7,7,7,0,0,0,0,0,0,0,0,0,0,0,0,0,0,0
0,0,0,0,0,0,0,0,0,0,0,0,0,0,0,1,1,7,1,1
0,0,0,0,0,0,0,0,0,0,1,1,7,1,1,0,0,0,0,0
0,0,0,0,0,1,1,7,1,1,0,0,0,0,0,0,0,0,0,0
z,z,0,z,z,0,0,0,0,0,0,0,0,0,0,0,0,0,0,0
w,w,6,w,w,0,0,0,0,0,0,0,0,0,0,0,0,0,0,0
