0,0,0,0,0,0,0,s,0,0,0,0,0,0,0,0,0,0,0,0
0,0,0,0,0,0,0,0,0,0,1,1,7,7,1,1,1,1,1,1
0,0,0,0,0,1,7,7,7,1,0,0,0,0,0,0,0,0,0,0
0,1,1,1,1,0,0,0,0,0,0,0,0,0,0,0,0,0,0,0
0,0,0,0,0,0,0,0,0,0,0,0,0,0,0,1,1,7,1,1
0,0,0,0,0,0,0,0,0,0,1,1,7,1,1,0,0,0,0,0
0,0,0,0,0,1,1,7,1,1,0,0,0,0,0,0,0,0,0,0
z,z,0,z,z,0,0,0,0,0,0,0,0,0,0,0,0,0,0,0
w,w,0,w,w,0,0,0,0,0,0,0,0,0,0,0,0,0,0,0
