0,0,0,0,0,0,0,0,0,0,0,0,0,0,0
0,0,0,0,0,0,0,0,0,0,0,0,0,0,0
0,0,0,0,0,0,0,0,0,0,0,0,0,0,0
0,0,0,0,0,0,0,0,0,0,0,0,0,0,0
0,0,0,0,0,0,0,0,0,0,0,0,0,0,0
0,0,0,0,0,0,0,0,0,0,0,0,0,0,0
0,0,0,a,0,0,0,0,0,0,0,0,0,0,0
z,z,z,z,z,z,z,z,z,z,z,z,z,z,z
w,w,w,w,w,w,w,w,w,w,w,w,w,w,w