0,0,0,0,0,b,0,0,f,0,0,0,0,0,0,0
0,0,0,0,0,b,0,0,1,0,0,0,0,0,0,0
0,0,0,0,0,b,0,0,0,0,0,0,0,0,0,0
0,0,b,b,0,1,0,0,1,1,0,0,0,0,0,0
0,0,b,0,0,0,0,0,0,0,0,0,0,0,0,0
0,0,b,0,0,0,0,0,0,0,0,1,1,1,0,0
0,0,b,0,0,0,0,0,3,0,0,0,0,0,0,0
1,1,1,0,1,1,1,1,1,1,1,0,0,0,1,1
0,0,0,0,0,0,0,0,0,0,0,0,0,0,0,0
