0,0,0,0,0,0,0,0,0,0,0,0,0,0,0,4,0,0
0,0,0,0,0,0,0,0,0,0,0,0,0,0,0,0,0,0
0,0,0,0,0,0,0,0,1,1,0,0,0,0,0,0,0,0
0,0,0,0,0,0,0,0,0,0,0,0,0,0,0,0,0,0
0,0,0,1,1,1,0,0,0,0,0,0,0,0,0,0,0,0
0,0,0,0,0,0,0,0,0,0,0,0,0,0,0,0,0,0
0,0,f,0,0,0,0,0,0,0,0,3,0,0,0,0,0,0
1,1,1,1,7,1,1,1,1,1,1,1,1,7,7,1,1,1
0,0,0,0,0,0,0,0,0,0,0,0,0,0,0,0,0,0