0,0,0,0,0,0,0,0,0,0,0,0,0,0,0,0,f,0,0
0,0,0,0,0,0,0,0,b,0,0,0,1,1,1,1,1,0,0
0,0,0,0,0,0,0,0,b,0,0,0,0,0,0,0,0,0,0
0,0,0,0,0,0,b,0,b,0,0,0,0,0,0,0,0,0,0
0,0,0,0,0,b,b,0,b,s,0,0,0,0,0,0,0,0,0
0,0,0,0,b,b,b,0,b,b,b,b,0,0,0,0,0,0,0
0,0,0,b,b,b,b,0,0,0,0,0,0,0,0,0,5,0,0
z,z,z,z,z,z,z,z,z,z,z,z,z,z,z,z,z,z,z
w,w,w,w,w,w,w,w,w,w,w,w,w,w,w,w,w,w,w