0,b,0,0,0,0,0,0,0,0,0,0,0,0,0,0
0,b,0,0,0,0,0,0,b,b,0,b,b,0,0,0
0,b,b,b,b,b,b,0,b,0,0,0,0,0,0,0
0,b,0,0,0,0,0,0,b,0,0,0,0,0,0,0
0,b,b,b,0,b,b,b,b,b,b,b,b,0,0,0
0,0,0,0,0,0,0,0,0,0,0,0,0,0,0,0
0,0,0,0,0,0,0,0,0,0,0,3,0,0,0,0
z,z,z,z,z,z,z,z,z,z,z,z,z,z,z,z
w,w,w,w,w,w,w,w,w,w,w,w,w,w,w,w
