0,0,0,0,0,b,0,0,f,0,0,0,0,0,0,0
0,0,0,0,0,b,0,0,1,0,0,0,0,0,0,0
0,0,0,0,0,b,0,0,0,0,0,0,0,0,0,0
0,0,b,b,0,b,0,0,1,1,0,0,0,0,0,0
0,0,b,0,0,0,0,0,0,0,0,0,0,0,0,0
0,0,b,0,0,0,0,0,0,0,0,1,1,1,0,0
0,0,b,0,0,0,0,0,3,0,0,0,0,0,0,0
z,z,z,0,z,z,z,z,z,z,z,0,0,0,z,z
w,w,w,0,w,w,w,w,w,w,w,0,0,0,w,w