0,0,0,0,0,0,0,0,0,0,0,0,0,0,0,0
0,0,0,v,0,0,0,0,0,0,0,0,0,0,0,0
0,0,0,0,7,1,0,0,0,0,0,0,0,0,0,0
0,0,1,1,0,0,0,0,1,1,0,0,0,0,0,0
0,0,0,0,0,0,0,0,0,0,0,0,0,3,0,0
0,0,0,0,0,0,0,0,0,0,0,1,1,1,0,0
0,0,0,0,5,0,0,0,1,1,7,0,0,0,0,0
z,z,0,0,z,z,z,r,0,0,0,0,0,0,z,r
w,w,0,0,w,w,w,w,0,0,0,0,0,0,w,w