0,0,0,0,0,0,0,0,0,0,0,0,0,0,0,0
0,0,0,0,0,0,0,0,0,0,0,0,0,0,0,5
0,0,0,0,0,0,0,0,b,b,0,0,0,0,0,1
0,0,0,0,0,0,0,3,b,b,0,0,0,0,0,0
0,0,0,0,0,0,b,b,b,b,b,b,0,0,0,0
0,0,0,0,b,b,b,b,b,b,b,b,b,0,0,0
0,0,b,b,b,b,b,b,b,b,b,b,b,b,0,0
z,z,b,b,b,b,b,b,b,b,b,b,b,b,z,z
w,w,b,b,b,b,b,b,b,b,b,b,b,b,w,w
